NO ./textures/eagle.xpm
SO ./textures/bluestone.xpm
WE ./textures/wall.xpm
EA ./textures/redbrick.xpm
S ./textures/barrel.xpm
FF ./textures/floor2.xpm
CC ./textures/floor2.xpm
SS ./textures/pillar.xpm

R 1920 1080
F 220,180,160
C 20,50,200

11111111111111111111111111111111111
10000000000000010000000000000000001
1000000001000001020S000001000000001
10010002010000010300020001000000001
11010000010011110200110001000000001
10010003000000000300110001111001111
10010000000000011220110000000000001
11110011110110001130110001111001111
10000000000110001120110001000000001
11000001110000001130300000000300001
11000001110000001120000000000000001
11000001110000001130000000000000001
11111111111111111111111111111111111
