R 1920 1080
F 80,187,223
EA ./textures/redbrick.xpm
NO ./textures/eagle.xpm
SO ./textures/bluestone.xpm
C 170,240,208
S ./textures/barrel.xpm
WE ./textures/greystone.xpm

        1111111111111111111111111
  11    1000000000110000000000001
11001  1011000001110000001000001
 111   10010W0000000000000200001
111111111011000001110000000000001
100000000110000011101111111111111
1111011111111101110000001000101
11110111111111011101010010010101
1100000011010101110000000100011
100010000000000001100000010001
100000000000000011010100100001
110000011101010111110111100111
11110111 1110101 101111010001
11111111 1111111 11111111111
